-0000-0000-C0vS-0000-0000-0000-0000-S0vE-PWvE-AWvS-
-B000-B000-AEvN-PEvW-PEvW-PEvW-ASvW-0000-B000-PNvS-
-ASvE-AWvS-B000-0000-B000-B000-PSvN-B000-AEvS-AWvN-
-PSvN-ANvE-PWvE-PWvE-PWvE-PWvE-AWvN-0000-PNvS-B000-
-PSvN-0000-B000-0000-0000-0000-B000-0000-ANvE-AWvS-
-PSvN-0000-AEvS-PEvW-PEvW-PEvW-ASvW-0000-B000-PNvS-
-PSvN-0000-PNvS-B000-0000-0000-PSvN-0000-AEvS-ANvW-
-PSvN-B000-PNvS-0000-0000-0000-AEvN-PEvW-ANvW-B000-
-AEvN-PEvW-ANvW-B000-0000-0000-0000-0000-0000-0000-